111111111111
100000C00001
100000C00001
1P000E00000111
111111111111