111111111111111111
100000000000000001
100000P00000000001
100000000000000001
100C00011110000001
100000011110000001
111111110010000001
100000000010000001
100G00001110000001
100000000000000001
100E00000000001111
100000000000001001
100000000000001001
100000000000000001
111111111111111111