111111111111111
1E0000000000C01
110000000000011
11P000000000001
111111111111111