111111111111111
1CCCCCCCCCECCC1
11CCCCCCCCCCC11
11PCCCCCCCCCCC1
111111111111111