111111111111111111
100000000000000001
100000P000E0000001
100000000000000001
100C00011110000001
100000011110000001
111111110010000001
111111111111111111