111111111111
100001C10001
101001C10001
1P10E0100111
111111111111