1111111111111111111111
1000000000000000000001
10000P0000000000000001
1000000000000000000001
10000E0000000000C00001
1111111111111111111111