1111111111111111111111
1000000000000000000001
10000P000011110C000001
1000000000100110000001
10000E0000100000C00001
1111111111111111111111