111111111111111111
100000000000000001
1P00000000E00000C1
100000000000000001
111111111111111111