111111111111111111
10000000E000000001
100000000000000001
100000000000000001
100000011110000001
100000011110000001
11111111CC10000001
1000C0000010000001
100000001110000001
100000000000000001
100000000000001111
100000000000001P01
1000C0000000001001
100000000000000001
111111111111111111