111111111111111111
1E0000000000000001
100000000000000G01
10GCC0000000000001
100000011110000001
100000011110000001
111111110010000001
100000000010000001
100000001110000001
100000000000000001
100000000000001111
100000G00000001001
100000000000001001
1000000000P0000001
111111111111111111