11101111
1P00C001
100000E1
11111111