11111111
111P1111
11111111
11111111