11111111
1P00C001
10000001
11111111